#################################.###############################
#.........#.......#...#.........#...#...#.....#.....#...#.......#
#.#####.#.###.#.###.#.#.###.###.#.#.#.#.#.###.#.###.#.#.#.#.#####
#.#...#.#.....#.#...#.#.#.#...#...#...#.#.#.#.#.#.#...#.#.#.....#
#.###.#.#####.###.###.#.#.###.#.#######.#.#.#.#.#.#####.#.#####.#
#.#...#.#...#.#...#...#...#...#.#...#...#.#...#.......#...#...#.#
#.#.###.#.#.#.#.###.#####.#.#####.#.###.#.###########.#######.#.#
#...#...#.#.#.#...#.......#.......#...#.#.#.....#.....#.....#.#.#
###.#.###.#.###.#########.###########.#.#.#.###.#.#####.###.#.#.#
#...#.....#.#...#.......#.....#.......#...#...#...#.....#...#.#.#
#.#########.#.###.#####.#####.#.#########.###.#####.###.#.###.#.#
#.....#.....#...#.#.....#.#...#.#.......#.#...#...#...#.#.#...#.#
#####.#.#######.#.#####.#.#.###.#####.#.#.#.###.#.###.#.#.#.###.#
#...#.#.........#.....#.#...#...#...#.#.#.#.#...#...#.#.#...#...#
#.###.###############.#.###.#.###.#.#.###.#.#.###.###.#.###.#.###
#.....#...#...#.....#.#...#.#.#...#.#.#...#.#...#.#...#...#.#...#
#.#####.#.#.#.#####.#.###.###.#.###.#.#.###.###.#.#.#####.#.###.#
#.......#...#.......#.#.#...#...#...#.....#...#.#...#...#.#...#.#
###################.#.#.###.#####.#######.###.#.#######.#.#######
#...#.....#...#.....#.#...#...#...#...#...#...#.#.....#.#.......#
#.#.#.###.#.#.#.#####.#.#.###.#.#.#.#.#####.###.#.#.#.#.#######.#
#.#.#...#...#.#.#.#...#.#...#...#.#.#.....#...#.#.#.#...#.....#.#
#.#####.#####.#.#.#.###.###.#####.#.#####.###.#.###.###.#.###.#.#
#.#...#.....#.....#...#...#...#.#.#...#.#...#.#.....#...#.#.#.#.#
#.#.#.#.#####.#######.###.###.#.#.###.#.###.#.###########.#.#.#.#
#.#.#...#...#...#.....#...#.....#.#...#...#...#.......#...#...#.#
#.#.#####.#.#####.#####.#########.#.#####.#####.#####.#.###.###.#
#...#...#.#.......#...#...........#.#...#.......#...#...#.#...#.#
#.#####.#.#########.#.#.###########.#.#.###.#######.#####.###.#.#
#.#...#.#.#...#...#.#.#.....#.....#...#...#...#.......#.....#.#.#
#.#.#.#.#.#.#.#.#.#.#.#######.###.#######.###.#.#######.###.#.#.#
#...#...#...#...#...#...........#.............#...........#.....#
#################################.###############################
