#################################
#.......#.............#.........#
#.###.#.#.###.#######.###.#####.#
#...#.#.#.#.#.#.....#...#.#.....#
###.#.###.#.#.#####.###.#.#.#####
#...#.......#...#.....#.#.#...#.#
#.#############.#.###.#.#.###.#.#
#...#.....#.....#.#...#.#.#.#.#.#
###.#.#.###.#####.#.###.#.#.#.#.#
#...#.#...#...#...#...#...#.#...#
#.#######.###.#.#.###.#####.###.#
#.........#...#.#.#.#...#.....#.#
#######.###.#####.#.###.###.#.#.#
#...#...#...#...#.#.#...#...#.#.#
#.#.#.###.###.#.#.#.#.###.#####.#
#.#.#.#.#...#.#...#.......#...#.#
#.#.#.#.###.#.###.#######.#.#.#.#
#.#.#.....#.#.$$#.#...#...#.#...#
###.###.###.###.###.#.###.#.#####
#.#...#.#...#...#...#...#.#...#.#
#.###.###.###.###.#####.#.###.#.#
#...#...#.#...#...#...#.#.#...#.#
#.#.###.#.#.###.###.###.###.###.#
#.#...#.#.#.#...#...#...#...#...#
#####.#.#.#.#.###.###.###.###.#.#
#.....#...#.#...#...#...#.#.#.#.#
#.#########.###.###.###.#.#.#.#.#
#.....#.....#...#...#...#.#...#.#
#.###.#.#.###.###.###.###.#####.#
#.#.#...#.#...#...#...#...#...#.#
#.#.#####.#.#####.#.###.###.#.#.#
#.......#.........#.........#...#
#################################
