#################################
#...#...........#.......#.......#
#.#.#.#######.#.#.#.#####.#####.#
#.#.#.#...#...#.#.#.#.......#...#
###.#.###.#.###.#.#.#.#######.#.#
#...#.....#.#...#.#.#.#...#...#.#
#.#.#####.#.###.#.#.#.#.###.###.#
#.#.#.....#...#.#.#...#.#...#.#.#
#.###.#######.###.#####.#.###.#.#
#...........#...........#...#.#.#
#.#########.###########.###.#.#.#
#.#...#...#.....#...#.....#.#...#
###.#.#.#.#######.#.#.#####.#.###
#...#...#...#.....#.#.#.....#.#.#
#.#########.#.#####.#.#.#####.#.#
#...#.#...#..$#$#...#.#.....#...#
#.#.#.#.#.#####.#.###.#####.#.###
#.#.#...#.......#.#.#.#.....#.#.#
#.#.#######.#.###.#.#.#.#######.#
#.#.......#.#.#...#...#.#.......#
#.#######.#.#.#.###.###.#.#######
#.....#...#.#...#.#...#.#.#.....#
#.#####.###.#####.#.###.#.#.#####
#.#.....#...#.......#...#.#.#...#
###.#.#####.#########.###.#.#.#.#
#...#.#...#.........#.#...#.#.#.#
#.#####.#.#########.#.#.###.#.#.#
#...#...#.#.....#...#.#.#.....#.#
#.#.#.###.###.#.#.###.#.###.###.#
#.#.#.#.#...#.#.......#...#...#.#
#.#.#.#.###.#############.#####.#
#.#.......#.....................#
#################################
