#################################################################
#.........#.........#.......#.......#...........#.........#.....#
#.###.###.#.#####.#.#.#.#####.###.#.###.#.#####.###.#####.###.###
#...#...#.#.#...#.#.#.#.......#...#...#.#...#.......#...#...#...#
###.###.###.#.#.#.###.#########.#####.#.###.#########.#####.#.#.#
#...#.#...#.#.#.#.............#.#...#.#...#.#...#.....#.....#.#.#
#.###.###.#.###.#############.#.#.#.#.#####.#.#.#####.#.#######.#
#.#.....#.#...#...#.........#.#.#.#.......#.#.#.....#...........#
#.#.###.#.###.###.#.#######.#.#.#########.#.#.#####.###########.#
#.#.#...#.........#.....#...#.#...#.....#.#.#.#...#...#.......#.#
#.###.#################.#.###.###.#.###.#.#.#.#.#.###.#.#####.#.#
#.#...#...............#.#.#.....#.#...#.#.#.....#...#.......#.#.#
#.#.#.#.#####.#######.#.#.#####.#.#.###.#.###.###########.###.#.#
#.#.#.#...#...#.....#...#.....#.#...#...#...#.#.........#.#...#.#
#.#.#####.#####.###.#########.#######.#####.###.#######.###.###.#
#...#...#.....#...#.#.#.....#..$#$....#...#.....#.......#...#.#.#
#####.#.###.#.###.#.#.#.###.###.#.#######.#######.#######.###.#.#
#.#...#...#.#.....#.#.#.#.#.....#.#.............#.#.....#.#...#.#
#.#.#####.#.#######.#.#.#.#######.#.#######.#####.###.#.#.###.#.#
#...#.#...#.#.#...#.#...#.....#...#.#.......#.....#...#.#.#...#.#
#####.#.###.#.#.#.#.#.###.###.#.###.#.#######.#####.###.#.#.###.#
#.......#...#.#.#...#.....#...#.#...#...#.....#.#...#.#.#.#.....#
#.#######.###.#.###########.###.#.#######.#####.#.#.#.#.#.#.#####
#...#...#.....#.#...#.....#...#.#...#.....#.......#.#.#...#...#.#
###.#.#.#######.#.#.#.###.###.#.#.#.#.#############.#.#######.#.#
#.#...#.........#.#...#.....#.#.#.#.#.#...........#.#.......#.#.#
#.#####################.###.#.#.###.#.#.###.#####.#.###.#.###.#.#
#.......#.....#.........#.#.#.#...#...#.#...#.....#.#...#.#...#.#
#.#####.#.#.#.#.#.#######.#.#.#.#.###.#.#.###.#####.#.###.#.###.#
#.#...#.#.#.#.#.#.....#.....#.#.#...#.#.#...#...#...#.#...#.....#
#.###.#.#.#.###.#####.#######.#####.#.#####.###.#.###.#########.#
#.....#...#.........#...............#.......#.....#.............#
#################################################################
