#################################
#...#.....#.....#.......#.....#.#
#.###.#.###.#.#.#####.#.###.#.#.#
#.....#.....#.#.......#...#.#...#
#.###########.#.#########.#.###.#
#.#.........#.#.#.......#...#.#.#
#.###.#####.#.###.#####.#####.#.#
#...#.#.#...#.#.......#.#.......#
###.#.#.#.#.#.#.#######.###.#####
#...#.#.#.#.#.#.#.....#...#...#.#
#.###.#.#.###.#.#.###.###.###.#.#
#...#...#...#...#.#...#...#.#...#
###.###.###.#####.#.###.###.###.#
#.#...#...#...#...#.#...#.#...#.#
#.###.#######$#$###.#.###.#.#.#.#
#...#.#.......#.#.#.#...#...#...#
#.#.#.#.#####.#.#.#.#.#.#.#######
#.#.#.#.#...#.#.#.#.#.#.#...#.#.#
#.###.#.#.#.#.#.#.#.#.#.###.#.#.#
#.....#.#.#...#.#.#.#.#.#.....#.#
#.#####.#.#####.#.#.#.#.#######.#
#...#...#...#...#.#.#.#.#.......#
###.###.###.#.###.#.###.#.#######
#.#...#...#.#.#.....#...#.......#
#.###.#.#.###.#.#####.#.#######.#
#...#.#.#...#.#.......#...#...#.#
#.###.#####.#.#########.###.#.#.#
#.#...#...#.#...#.......#...#...#
#.#.###.#.#.###.#.#######.#######
#...#...#...#.#.#...#.....#.....#
#.###.#####.#.#.#####.#########.#
#.....#.......#.................#
#################################
