#################################################################
#.....#...............#.............#.....#...#.....#.....#.....#
#.#.#.###########.###.#.###########.#.#.#.#.#.#.#.#.#.###.#.###.#
#.#.#.#...........#.#...#.......#...#.#.#.#.#...#.#.#.#.#.#...#.#
#.#.#.#.###########.#######.#####.###.#.#.#.#####.#.#.#.#.#.#.###
#.#.#...#.............#...#.#.....#...#.#.#.#...#.#...#...#.#...#
###.#####.#####.#####.#.#.#.#.#########.#.###.#.#.#####.###.###.#
#...#.....#.....#...#...#.#.#...#.....#.#...#.#...#.....#.#...#.#
#.#####.#########.#.#####.#.###.#.###.#.###.#.#####.#####.###.#.#
#.#...#...#...#...#.#.......#...#...#...#.#...#.#...#...#.....#.#
#.#.#.#.#.#.#.#.###.#######.#.#####.#####.#####.#.###.#.#######.#
#...#.#.#...#...#.#.....#.#.#.......#.....#.....#.#...#.........#
#####.#.#########.#####.#.#.#########.#####.###.#.###.#########.#
#.....#.#.....#.......#.#.....#.......#.....#.#...#...#.#.......#
#.#####.#.###.#.#####.#.#######.#.#####.#####.#####.###.#.#######
#.#...#...#...#...#.#.#.....#$$.#.#.....#.........#.#.....#.....#
#.#.#.#####.###.#.#.#.#####.#.###.#.#########.###.#.###.#######.#
#.#.#...#...#...#.#.#.#...#...#.#.#...........#.#.#...#.........#
###.###.#.#######.#.#.#.#.#####.#.#############.#.###.#########.#
#.#.#...#.........#...#.#.#.#...#.......#.......#.....#.#.....#.#
#.#.#.#############.###.#.#.#.#.#####.#.#.#####.#######.#.###.#.#
#...#.#.....#.....#.....#.#...#.....#.#.#.....#.........#.#.#.#.#
#.###.#.#.#.#.###.#######.#####.###.#.#.#####.#######.###.#.#.#.#
#.#.#...#.#...#...#.....#.......#...#.#.#...#...#.....#...#.#...#
#.#.#####.#####.###.#.#.#########.###.###.#.###.#.#####.###.#####
#.#.....#.#.....#...#.#.........#.#.#.....#.....#.#.....#.......#
#.#.###.#.#.#####.###.#.#######.#.#.#############.#.#####.#.#####
#.#...#.#.#.#.....#...#.#.....#.#...#.....#.....#.#...#...#.....#
#.#####.#.#.#.#####.###.#.###.#####.#.###.#.#.#.#.###.#####.###.#
#...#...#.#.#.#...#.#...#...#.....#.#...#.#.#.#.#.....#...#...#.#
###.#.#.#.###.#.#.#.#######.###.###.###.#.###.#.#######.#.#####.#
#.....#.#.......#.#...........#.........#.....#.........#.......#
#################################################################
