#################################################################.###############################################################
#.......#...........#.........#.....#.....#.......#...#.......#.........#...#.............#.......#...#.......#.........#.......#
#.#.###.#.#########.#######.###.#.#.#.#####.#####.#.#.#.###.#.#####.###.#.#.#.#.###.#######.#.###.###.#.###.###.###.###.#####.###
#.#.#.....#.......#...#...#.....#.#.#.........#.#...#...#...#.....#.#...#.#...#.#...#...#...#...#.....#.#.#...#...#.#.......#...#
#.#.#########.###.###.#.#.###.###.#.#########.#.#########.#######.###.###.#####.#####.#.#.#####.#######.#.###.###.#.#######.###.#
#.#.#...#...#...#...#.#.#...#...#.#.........#.....#...#...#.....#.....#...#...#.......#...#...#.............#.....#.....#.#.....#
###.#.#.#.#.#####.#.#.#.###.#####.#########.#####.#.###.###.###.#.#####.#####.###############.#########################.#.#####.#
#...#.#...#.....#.#.#...#.#.......#.......#...#.#.#...#...#...#.#.#.....#.....#...............#.......#...#.....#.......#.#.....#
#.#.#.#########.###.#####.#############.#####.#.#.#.#.###.#####.#.#.#####.#####.#######.#####.#.#.###.#.#.#.###.#.#######.#.#####
#.#.#.#.......#...#.#.......#...........#...#.#...#.#...#.#...#...#...#...#.....#...#...#.#...#.#.#...#.#...#.#...#.............#
#.#.#.#.#####.###.#.#.#####.#.#.#######.#.#.#.#.#####.#.#.#.#.#######.#.#.#.#####.#.#.###.#.###.#.#.###.#####.#####.###########.#
#.#.#.#.....#.#...#...#.....#.#...#.....#.#...#.......#.#...#.......#.#.#...#.....#...#...#.#...#.#.#...#.........#.#.#.....#...#
#.###.#.###.#.#.###.###.###.#.###.#######.#################.#####.###.#.#####.###########.#.#.###.#.#.#######.###.#.#.#.###.#####
#.....#...#.#.#...#...#.#...#.#.#.........#.......#...#...#.#...#.#...#.....#.#.#...#.....#.#.#.#.#.#.#.....#...#...#.#.#.#.....#
#.#########.#####.###.#.#.###.#.#############.###.#.#.#.#.###.#.#.#.#########.#.#.#.#.#.###.#.#.#.###.#.###.###.#####.#.#.#####.#
#...#.....#.#.....#...#.#.#...#.....#.........#.#...#...#.#...#.#.#...........#.#.#...#...#.#...#...#.#.#.#...#.......#.#.#.....#
###.#.#.#.#.#.#########.#.#.###.###.#.#####.###.#########.#.###.#.#############.#.#######.#.###.###.#.#.#.###.#######.#.#.#.###.#
#...#.#.#.#.#.........#.#.#.....#.#.#.....#.#...#...#.....#...#...#...#...#.#.....#.....#...#.....#.#...#...#...#.#...#...#.#.#.#
#.#####.#.#.#########.#.#########.#.###.###.#.#.#.#.#.#######.###.#.#.#.#.#.#.#####.###.###########.#####.#.###.#.#.#####.#.#.#.#
#.......#.#...#.......#...#.........#...#...#.#...#.#.........#.#...#...#...#.#...#.#...............#.....#...#.#...#.....#.#.#.#
#########.#.###.#######.#.#.###########.#.#########.###########.#######.#####.#.#.###.#############.###.###.###.#.###.#####.#.#.#
#.......#...#...#.....#.#...#.........#.#...#.....#...................#.#...#.#.#.....#.....#.....#.#...#...#...#...#...#.#.#...#
###.#.#####.#.###.###.#.#####.#######.###.#.#.###.#.#####.###########.#.#.#.#.#.###########.#.###.#.#.###.###.#########.#.#.###.#
#...#.#.....#.....#...#...#.......#.#...#.#...#...#.#...#.....#.....#.#.#.#...#.#.#.....#...#.#.#...#.#...#.#...#.....#.#.#...#.#
#.#####.###########.#####.#####.#.#.###.#.#####.###.#.#######.#.###.###.#.#####.#.#.#.#.#.###.#.#####.#.###.###.#.###.#.#.###.#.#
#.................#...#.#.....#.#.#...#.#.....#...#...#.....#.#...#...#.#.#.#...#...#.#.#.#...#.......#.#.....#...#.#.#.#.#...#.#
#.###############.###.#.#####.###.###.#.#########.#.###.###.#.###.###.#.#.#.#.#.#.###.#.#.#.###.###.###.###.#######.#.#.#.#.###.#
#.....#.....#.....#.#.#...........#...#...#...#...#.#...#.......#.#.#.#.#.#...#.#.#...#...#.#.....#.#.#...#.....#...#.#.#.#.#...#
#######.###.#.#####.#.#############.#####.#.#.#.#####.###.#######.#.#.#.#.#####.#.#.#######.#.#####.#.###.###.###.#.#.#.#.#.#.###
#.....#.#...#...#...#...........#.......#...#...#.....#...#...#...#.#...#...#...#.#.........#.#.....#...#...#.....#.#.....#.#.#.#
#.###.#.#.#####.#.#.###########.#.###.###########.#####.###.#.#.###.#######.#.###.###########.#.#####.#####.#######.#######.#.#.#
#.#.#.#.#.....#.#.#.......#...#.#...#.#...........#...#.#.#.#...#...#.....#.#.#...#.#.......#.#.#.........#.......#.....#...#.#.#
#.#.#.#.#####.#.#.#.#######.#.#.#####.#.#####.#####.###.#.#.#####.#.#.#.#.#.#.#.###.#.#.###.###.#.#######.#######.#####.#.###.#.#
#.#.#.#.#.....#...#.#.......#...#...#...#...#...#...#.....#.#...#.#.#.#.#.#...#...#...#.#.#.....#.#.#.......#...........#.#.....#
#.#.#.#.#####.#.#####.#######.###.#.###.#.#.###.###.#.#####.#.#.#.###.#.#########.#.###.#.#######.#.#.###.###.###########.#####.#
#.#.....#...#.#.#.....#.#...#.#...#...#.#.#.....#...#.#.....#.#.#.#...#.......#...#.#...#...#.....#.#...#.#.....#...#...#...#...#
#.#.#####.#.#.###.#####.#.#.#.#.#####.#.#.#######.###.#.#####.#.#.#.#########.#.###.#.###.#.#.#####.###.###.#####.#.#.#.###.#.###
#.#...#...#.#...#.....#.#.#...#...#...#.#.....#...#...#.#.....#...#.....#...#...#...#.#...#...#.....#.#.....#.....#.#.#.....#.#.#
#.###.#.###.###.#####.#.#.#######.#.#########.###.#.###.#.#.###########.#.#.#########.#.#####.#.###.#.#######.#####.#.#######.#.#
#.#...#.#.#.#...#...#.#.....#.....#.........#...#...#.#...#.#...........#.#.....#.....#.#...#...#.#.#.......#...#.#.#...#.#...#.#
#.###.#.#.#.###.#.#.#.#####.#.#############.###.#.###.#####.#.###########.#.###.#.#####.#.#.#####.#.#######.###.#.#.###.#.#.###.#
#...#.#...#...#...#.#...#.#.#.#...#...#...#...#.#.#.....#...#.#.....#.....#...#...#...#.#.#...#.............#...#.#...#.#.#...#.#
###.#####.###.#####.###.#.#.#.#.#.#.#.#.#.###.#.#.###.#.#.###.#####.#.#######.#.###.#.###.###.#########.#####.###.###.#.#.###.#.#
#...#.....#.#.....#.....#...#...#...#...#...#.#.#.....#.#.#...#...#.....#...#.#.#...#.....#.#.#.......#.#.....#.#.......#...#...#
#.#.#.#####.#####.#.#####.#########.#########.#.#######.#.#.###.#.#####.#.###.#.#.#########.#.#.#####.###.#####.#.#######.#.###.#
#.#.#.#.......#...#.#...#...#.#.....#...#.....#.#.......#.#.#...#...#.#.#.#...#.#...........#.#.#...#...#.#.....#.#...#...#.....#
#.###.#.#######.#####.#.###.#.#.#####.#.#.#####.###.#####.#.#.#####.#.#.#.#.#####.###########.#.#.#.###.#.#.###.#.#.#.#####.#####
#.....#.......#...#...#...#...#.#...#.#.#.#.#.....#.....#.#...#...#.#...#.#...#...#.....#.....#.#.#.#.....#...#...#.#.....#.....#
#.#########.#.###.#.#####.###.#.#.#.#.#.#.#.#.###.#######.#####.###.#.###.###.#.###.###.#.#####.#.#.#.#######.#####.#####.#####.#
#.#.......#.#.#...#.#.#...#...#.#.#...#...#.#.#.#.....#.........#...#.....#.#.#...#.#...#.....#...#.#.#...#...#.........#.#.....#
#.#.#####.#.#.#.###.#.#.###.###.#.#########.#.#.#####.#.#######.#.#######.#.#.###.#.#.#######.#####.###.#.#####.#########.#######
#...#.#...#.#.#...#...#.#.....#.#...#.........#.....#...#.#...#.#.#.........#.....#.#.............#...#.#.#.....#...#.....#.....#
#####.#.#####.###.###.#.###.###.###.#.#######.#####.#####.#.#.###.#################.#######.#####.###.#.#.#.#######.#.#####.###.#
#...#...#.....#.....#.#...#.#...#.#.#...#...#...#...#.....#.#.................#...#.#.....#.#...#...#...#.#...#...#.#.#...#...#.#
#.#.#.#####.#.#.###.#.###.#.#.###.#.###.#.#.###.#.#.#.#####.#################.#.#.#.#.###.#.#.#.###.#####.###.#.#.#.#.#.#.#.###.#
#.#...#.....#.#.#...#...#.#.#...#.#...#.#.#.#...#.#...#...#.#...#.....#.........#.#.#.#...#.#.#...#.#.....#...#.#.#.#...#.#.#...#
#.#######.###.#.#######.#.#.###.#.###.#.#.#.###.#.#####.#.#.#.#.#.###.###.#######.#.#.#.###.#.###.#.#.#.###.###.#.#.#####.#.#.#.#
#.......#.#.#.#.......#.#.#...#.....#.#.#.#...#...#.....#...#.#.#...#...#.#...#.....#.#...#.#...#.#.#.#.#...#...#...#...#...#.#.#
#######.#.#.#.#####.###.#.#########.#.###.###.###.#.#########.#####.###.###.#.###########.#.###.#.###.###.###.#####.#.#.#####.#.#
#.....#...#.#...#.#...#.#.#.........#...#...#.#.#.#.#.......#.#.....#.......#.#.........#.#...#.#...#.#...#...#...#.#.#...#...#.#
#.#.#######.###.#.###.#.#.#.#########.#.###.#.#.#.#.###.###.#.#.#####.#######.#.#######.#.#.###.###.#.#.###.#####.#.#.#.###.###.#
#.#.#.....#...#.#.#...#.#.#...#.#...#.#...#.#.#...#...#...#...#.#.....#.....#.#...#...#.#...#...#...#.#...#.#.....#...#.#...#.#.#
###.#.#.###.#.#.#.#.###.#.###.#.#.#.###.###.#.###.###.#.#.#####.#######.###.#.###.#.###.#.###.###.###.###.#.#.#.###.#####.###.#.#
#...#.#.....#.....#.....#...#...#.#.#...#...#...#...#.#.#.....#.........#.#.#...#.#.#...#...#...#.....#...#.#.#.....#.....#.....#
#.###.###############.#####.#.###.#.#.#.#.#####.#####.#######.###########.#.###.#.#.#.#########.#####.#.###.#########.#.#########
#.#...#...#.........#.#...#...#...#...#.#.....#.#...#.......#...#...#.....#.#.....#.......#...#.#.....#.#...#.....#...#.#.....#.#
#.#.###.#.#.#######.#.#.#######.#####.#######.#.#.#.#######.#.###.#.#.###.#.#######.#####.#.#.#.#.#####.###.#.###.#.#####.###.#.#
#.#.....#.#.#...#...#.#.......#.#...#.#.....#.#.#.#.......#.#.....#...#...#.#...#...#...#.#.#...#...#...#...#.#.#.#.....#.#.#...#
#.#######.#.###.#.###.###.###.#.#.###.#.#.###.#.#.#######.#.###.#######.#.#.#.#.#####.#.#.#.#.#####.#.###.###.#.#.#####.#.#.#####
#.......#.#.#...#.#.......#...#.#.....#.#.....#...#.....#.#...#.#.....#.#.#.#.#.......#.#...#.#...#.#.#.#.......#.....#.#.#...#.#
#.###.###.#.#.#.#.#.###########.#.#####.###########.###.#.###.#.#.###.#.#.#.#.#########.#######.#.###.#.#.###########.#.#.#.#.#.#
#.#.#.....#.#.#.#.#.#...........#.....#.#.........#.#...#...#.#.#.#.....#.#.#...#.....#.........#...#.#.#...#.........#...#.#...#
#.#.#######.#.#.#.###.#######.#########.#.#.#####.###.#.#.###.#.#.#.#######.###.###.#.#############.#.#.###.#.#######.#####.###.#
#...#.....#.#.#.#.....#.....#.#.....#...#.#...#.......#.#...#.#.#.#...#...#...#...#.#...........#.#...#...#.#.#.....#.#.....#.#.#
###.#.#.###.#.#########.###.#.#.###.#.#######.#########.###.#.###.#####.#.###.###.#.###.#######.#.#####.#.#.#.#.###.#.#####.#.#.#
#.#...#.#...#...........#...#.#.#.#...#.....#...#.....#.#.#...#...#.....#.#...#...#.#...#.....#...#...#.#...#.#...#.........#...#
#.#####.#.#########.#####.###.#.#.#######.#.###.###.#.#.#.#####.###.#####.#.###.###.#.###.###.###.###.#.#####.###.#######.#####.#
#.....#.#.....#...#...#...#...#...#.......#...#...#.#...#.....#.....#.#...#...#.#...#.#...#.#...#.....#.#...#.#...#.....#.#...#.#
#.#.#.#.#####.#.#.#.#.###.#.#####.#.#.#.#####.###.#.#####.#.###.#####.#.#####.#.###.#.#.###.###.#####.#.###.#.#####.###.#.#.#.#.#
#.#.#.#.....#...#.#.#...#.#.#.#...#.#.#.#...#.....#.#.....#.........#.#.#.....#...#.#.#.#.....#...#.#.#.....#.........#.#.#.#.#.#
#.#.#.#####.#####.#.###.###.#.#.#####.###.#.#######.###############.#.#.#.#######.#.###.#.###.###.#.#.#####.###########.###.#.###
#.#.#.#.....#...#.#...#.......#.....#.....#...#...#.............#...#.#.#.#.....#.#.....#.#...#...#.......#.#.....#...#.#...#...#
#.#.###.#####.###.###.#############.#########.#.###############.#.###.#.#.#.#.###.#####.###.#.#.#########.#.#.###.#.#.#.#.#####.#
#.#...#...#...#...#.........#.....#.#.........#.........#.....#.#.#...#.#...#...#.#...#.....#.#.......#.#.#.#...#...#...#.#...#.#
#.###.###.#.#.#.#############.###.#.#.#########.#.#####.#.###.#.#.###.#.#######.#.#.#.#######.#######.#.#.#.###.#####.###.#.###.#
#.#.#...#...#.#.........#.......#.#...#.......#.#...#.....#...#.#...#.#.......#...#.#.#.....#.#.....#.#...#.#.#.#...#.#...#...#.#
#.#.###.#####.#########.#.#######.#####.###.#.#.###.#.#######.#.###.#.#######.#####.#.#.#.###.#.###.#.#####.#.#.#.###.#.#####.#.#
#.#...#.#...#...#...#...#...#...#.......#...#.#.#.#.#...#...#.#...#...#.....#.......#.#.#.#...#...#.#.....#...#.#.....#.....#.#.#
#.#.#.#.#.#.###.###.#.#####.#.#.###.#####.###.#.#.#.###.#.#.#####.###.#.###.#######.#.#.#.#.#####.#.#####.###.#.###########.#.#.#
#.#.#.#...#...#.#...#.....#.#.#...#.....#.#...#.#.#...#.#.#...#...#...#.#.#.......#.#.#.#...#.....#.#.....#...#...............#.#
#.#.#.#####.#.#.#.#######.#.#.###.#.#####.#.###.#.###.###.###.#.#######.#.#######.#.#.#.###########.#.#.###.###################.#
#.#.#.....#.#.#...#.......#.#.#...#.#.....#...#.#...#...#...#...#.......#.......#...#.#.............#.#.#...#.........#.....#...#
#.#.#.#####.###.###.###.###.#.#.#####.#####.###.#.#.###.###.#####.###########.#.#####.#########.#####.#.#.#########.#.#.#.###.#.#
#.#.#...#...#...#...#...#...#.#...#...#...#.#...#.#...#.#...#.....#...#.......#.#...#.........#.#.....#.#...#...#...#.#.#.#...#.#
#.#.###.#.###.###.###.###.###.###.#.###.#.#.#.###.#.#.#.#.#######.#.###.#.#####.#.#.#########.#.#.#########.#.#.#.###.#.#.#.###.#
#.#.#...#...#.#...#.....#...#.#...#.#.#.#...#.#...#.#.#...#.......#...#.#.#...#...#.#.......#.#.#.........#...#.#.#.#.#.#.#.#...#
#.#.#.#####.#.#.###.#######.#.###.#.#.#.#####.#.###.#.#####.#########.#.#.#.#.#####.#.#####.#.#.#######.#.#####.#.#.#.###.#.#.###
#.#.#.....#...#.#...#.......#...#...#.#.#.#...#...#.#...#...........#...#.#.#...#...#.#...#...#.#.#...#.#...#...#.#.#.....#.#.#.#
#.###.###.#####.#.###.#########.#####.#.#.#.#######.#####.#####.###.#.###.###.###.###.###.#####.#.#.#.#.#####.###.#.###.###.#.#.#
#...#.#.......#.#.#...#.....#...#.....#.#.#.......#...#...#...#...#.#...#...#.....#.#.#...#...#.#.#.#...#.....#...#.#...#...#...#
###.#.#.#####.#.#.#.###.###.#.###.###.#.#.#######.###.#.###.#.###.#.###.###.###.###.#.#.#.#.###.#.#.#####.#######.#.#.###.#####.#
#...#.#.....#.#.#.#.#.#.#.#.#...#.#...#...#.....#...#...#...#.#.#.#...#...#...#.#...#...#.#.......#.#...#.#.....#.#...#.#.....#.#
#.#########.###.###.#.#.#.#.###.#.#######.###.#.###.#####.###.#.#.###.###.###.#.#.#######.#.#######.#.#.#.###.#.#.#.###.#####.#.#
#.........#...#.#...#.#.#.#...#.#...#.........#...#.......#.#.#.....#...#...#.#...#.....#.#...#.#...#.#.#.....#.#.#.#.......#.#.#
#########.###.#.#.###.#.#.###.#.###.#.###########.#########.#.#.#######.#####.###.#.###.#.###.#.#.###.#.#######.#.#.#.#.###.#.###
#.#.....#.....#...#...#.#...#...#...#...#.....#.#.#.......#...#...#.....#...#.#...#.#.#...#...#.#.....#.......#...#.#.#.#...#...#
#.#.#.#######.#####.#.#.###.#####.###.###.###.#.#.#.###.###.###.###.#####.#.#.#####.#.#####.###.#########.###.#####.###.#.#####.#
#...#.....#...#...#.#.#...#.......#...#...#...#...#.#.#.....#.#.#...#.....#.#.......#...#.........#.....#...#.#.....#...#...#...#
#.#####.#.#.###.#.#.#.###.#.#######.###.###.###.###.#.#######.#.#.###.#####.#.#######.#.#.#########.###.###.#.#.#####.#####.#.#.#
#.....#.#.#...#.#.#.#.#.#.#.....#...#.#.#.#.#.....#.......#.....#.......#...#.#.......#...#.....#...#...#.#.#.#.....#.#...#.#.#.#
#.#####.#####.#.#.#.#.#.#.#.###.#.###.#.#.#.#.###########.#.#############.###.###.#########.###.#.###.###.#.#.#####.#.###.#.#.#.#
#.#.....#...#.#.#...#...#.#...#.......#...#.#.#.........#.#.#...#...#...#.#.#...#.#.......#...#...#.#.#.#...#.....#.#...#...#.#.#
#.#.###.#.#.#.#.###.#####.###.#########.###.#.#.###.#####.#.#.#.#.#.#.#.#.#.###.###.#####.#.#.#####.#.#.#.#######.#.###.#.###.#.#
#.#...#.#.#...#...#.#.....#.....#.#...#.#...#.#.#.#.......#...#...#.#.#...#...#...#.#...#.#.#...#...#.#...#.....#.#.....#...#.#.#
#.###.###.#######.#.#.#########.#.#.#.#.#.#.###.#.#############.#####.#####.#.###.#.#.#.#.#####.#.#.#.#.###.#####.#########.#.###
#...#...#...#.....#.#.........#.#.#.#...#.#.#...#.......#.....#.#.....#...#.#...#...#.#.#.......#.#.#.#...#.....#.....#...#.#...#
#######.###.#.#####.#########.#.#.#.#####.#.#.###.#.###.#.###.#.#.#####.###.#.#######.###########.#.#.###.#####.#####.#.#.#.###.#
#.....#...#...#.#...#.......#.#...#...#...#.#.#...#...#.#...#.#.#...#...#...#.......#...#.......#.#...#.#.......#...#.#.#...#...#
#.###.#.#######.#.#########.#.#######.#.#.###.#.#####.#.###.#.#.###.#.###.#####.#.###.#.#.###.###.#####.#######.###.#.#.#####.#.#
#.#...#.........#.#.....#...#.#.....#.#.#.#...#.#...#.#.....#.#...#.#.....#...#.#.....#.....#.#...#.............#...#...#...#.#.#
#.#.#########.#.#.###.#.#.###.#.###.#.#.#.#.#####.#.#.#######.###.#.#.#####.#.#.#############.#.###########.#####.#.#######.#.#.#
#.#...........#.#.....#...#...#...#...#.#.#...#...#.#...#...#.#...#.#.#.....#.#.....#.......#.#.#.........#.....#.#...#...#.#.#.#
#.###.#########.#######.###.#####.#####.#####.#.###.###.#.###.#####.###.#####.#####.#.#####.#.#.#.#######.#####.#.###.#.#.#.#.#.#
#...#.#.......#...#.....#...#...#...#.#.....#...#.#...#.#.#...#...#.......#...#...#.#.....#...#.#...#.#...#...#...#.....#...#.#.#
#.#.#.#.#####.#####.#####.###.#.###.#.###.#######.###.#.#.#.###.#.#########.###.#.#.#####.#####.###.#.#.###.#######.#########.#.#
#.#.#.#.#.#...#...#...#...#...#.....#...#.#...#.....#...#...#...#.......#...#...#...#.....#...#...#.#.#.#...........#.........#.#
#.#.###.#.#.###.#.###.#.###.###########.#.#.#.#.#.#######.###.#########.#.###.#######.#####.#.###.#.#.#.#############.#########.#
#.#.......#.....#.....#.................#...#...#.............#...........#.........#.......#.......#.................#.........#
#################################################################.###############################################################
