#################################################################.###############################################################
#.................#.......#...................#...........#.....#...#.........#...#.......#.........#.#...........#...........#.#
#.#.###########.###.#.###.#.###########.#####.#########.#.#.###.#.#.#.###.###.#.#.#.###.#.###.#####.#.#.###.#.#####.#####.###.#.#
#.#...#.#.......#...#.#.#.#.....#.....#.#.#...#.........#...#...#.#...#.#...#.#.#...#...#.....#...#...#.#...#.#...#.#...#.#.....#
#.###.#.#.#######.###.#.#.#####.###.###.#.#.###.#.###########.#####.###.###.###.#####.#######.#.#.#####.#.#####.#.#.#.#.#.#######
#.#...#.#...#...#...#.#.#.#...#...#.#...#.......#.#...#.....#.....#.......#.....#.....#.......#.#.......#...#...#.#...#.#...#...#
#.#.###.###.#.#.#.###.#.#.#.#.###.#.#.###.#########.#.###.#######.###############.#####.#######.###########.#.###.###.#####.#.#.#
#.#.#.......#.#...#...#.....#.#.#...#...#.#...#.....#...#.#.......#...........#...#...#.#...#.#.#.......#...#.#.....#.#.....#.#.#
###.#.#######.#####.#########.#.#.#####.###.#.#.#######.#.#.#######.#.#######.#.###.###.#.#.#.#.#.###.#.#.###.#.#####.#.#####.#.#
#...#.#.....#...#.#.......#...#.#.#.....#...#.#...#.#...#.#.#...#...#.#...#.#...#.........#...#.#.#...#.#.#...#.......#.....#.#.#
#.###.#####.###.#.#######.###.#.#.#.###.#.###.###.#.#.###.#.#.#.#.#.###.#.#.###.###############.###.###.#.#.###############.#.#.#
#...#.....#.#...#.......#...#.#...#.#.#.#.#.#...#...#.#...#.#.#...#...#.#.#...#.#.............#...#.#...#.#.#.......#.....#...#.#
###.#####.#.#.###.#########.#.#.###.#.#.#.#.###.###.#.###.#.###.#####.#.#.###.#.#.###########.###.#.###.#.#.###.#####.###.#####.#
#...#...#...#.#...#.........#.#...#.#...#.....#.#...#...#.#...#.#...#.#.#...#...#.......#.#.....#.#...#.#.#...#.....#.#.........#
#.###.#####.#.###.#.#########.#####.#.#######.#.#.#####.#.###.#.###.#.#.###.#.#########.#.#.#####.#.#.###.###.#.###.#.#########.#
#.#.........#.#...#...#.....#.......#.#.......#...#...#.#.....#.#...#...#.#.#.#...#...#...#.......#.#.#...#...#.#...#.....#.#...#
#.###.#######.#.#####.#.###.#######.###.###########.#.#.###.###.#.#.#####.#.#.#.#.###.###.#######.###.#.###.#####.#.#####.#.#.###
#...#.#.....#.#.#.....#.#...#.....#.#...#...#...#...#.#...#.#.....#.......#.#...#.....#.....#...#.....#.#...#.....#.#...#.#.#.#.#
###.#.###.#.#.#.#.#######.###.###.#.#.###.#.#.#.#.###.###.#.#########.#####.#####.#####.#####.#.###.###.#.###.#####.#.#.#.#.#.#.#
#...#.#...#.#.#.#.......#...#.#.#...#.#...#.#.#...#.....#.#.....#.....#.....#...#.#.....#.....#...#.#...#.#...#...#...#.#.#.....#
#.###.#.###.#.#.#######.###.#.#.#####.###.#.#.#########.#.#####.#.#####.#####.#.###.#####.#######.#.#.###.###.#.#######.#.#####.#
#.#...#.#...#.#...#.....#...#.......#...#.#.#.......#...#.#...#.#.#.#...#.....#.....#.....#.......#.#...#...#.#.....#...#.#...#.#
#.#.###.#.###.#.#.#.#####.#########.###.###.#######.###.#.#.#.#.#.#.#.#.#.###########.#####.#########.#.###.#.#.###.#.###.#.#.###
#.#.#...#...#.#.#.#.#.........#.......#...#.....#.#...#...#.#...#...#.#.#.#.........#.#...#.........#.#...#...#...#...#.#...#...#
#.#.#.###.###.#.#.#.#######.###.#########.#.###.#.###.#####.#######.#.###.#####.###.#.#.###########.###.#.#######.#####.#####.#.#
#.#.#.#...#...#.#.#.......#.....#...#...#.#.#...#...#.#...#.#.......#...#.......#...#.#.........#...#...#...#...#...#...#...#.#.#
#.#.#.#.###.###.#########.###.###.#.#.#.#.#.#.###.###.#.#.#.###.#######.#####.#######.###.#####.#.###.#####.#.#####.#.#.#.#.###.#
#.#...#...#...#.....#...#...#...#.#.#.#...#.#.....#...#.#.#...#.#...#...#.....#.....#...#.#.....#.....#.....#.....#.#.#.#.#...#.#
#.#######.###.###.#.###.###.###.#.#.#.#####.#######.###.#####.###.#.#.###.#####.###.###.#.#####.#######.#######.###.###.#.###.#.#
#.......#.#.#.#...#.......#...#.#.#.#.#.....#...#...#.......#...#.#...#...#.#...#.#...#.#.....#.....#.#...#...#...#.....#.#.#.#.#
#####.#.#.#.#.#.#########.###.#.#.#.#.###.###.#.#.#####.###.###.#.###.#.###.#.###.###.#.#####.#####.#.###.#.#.###.#####.#.#.#.#.#
#...#.#.#...#...#...#.#...#.#.#...#.#...#...#.#.#.....#...#...#...#...#.....#...#.......#...#.....#.....#...#.....#...#.#.#.....#
#.#.###.###.#####.#.#.#.###.#.#########.#.#.#.#.#####.###.#.#######.#######.###.#########.#.#####.###.###########.#.###.#.#####.#
#.#.....#.#.#.....#...#.#...#.......#...#.#.#.#.....#.#...#.#...........#.#...#.#.........#...#...#...#.......#.#...#...#...#...#
#.#######.#.#####.#.###.###.#######.#.###.#.#.###.#.#.###.#.#.#########.#.###.#.#.###########.#.#######.#.###.#.#.###.#####.#.###
#...#.....#.....#.#.#...#.....#.....#...#.#...#...#.#...#.#...#.......#.....#.#.#...#...#.....#.........#.#.....#.#...#.#...#.#.#
###.#.###.#####.#.#.#.###.#.###.#######.#.#####.###.###.#.#####.#####.#####.#.#.###.###.#.#####.#########.#######.#.###.#.###.#.#
#...#.#.......#...#.#.....#.#...#.......#.....#.#...#...#.....#...#.#.....#.#.#.........#.#.......#.....#.........#.....#...#.#.#
#.#####.#######.#####.#######.###.#############.#.###.###########.#.#####.#.#.###########.#.#######.###.#.#############.###.#.#.#
#.....#...#.....#.....#.......#...#.......#.....#...#...........#.#...#.#.#.#.#...........#.#...#.....#.#.#.........#.....#.#.#.#
#.###.#.#.#.#####.#####.#####.#.###.#####.#.###.###############.#.#.#.#.#.###.#.#####.#######.#.#.#####.#.#####.#.###.#####.#.#.#
#.#.#.#.#...#...#...#...#...#.#.#.......#...#.#.#.....#...#...#.....#...#...#.#.....#.#...#...#.#...#...#.......#.#...#.#...#...#
#.#.#.#######.#.###.#.###.#.###.#.#####.#####.#.#.###.#.#.#.#.#########.###.#.#####.###.#.#.###.#.###.#########.###.###.#.#######
#.#.#...#.....#.#...#.#...#.#...#.#...#.#.....#.#.#.#...#...#.#...#...#...#.#...#.#.....#...#.#...#...#.....#...#.......#.......#
#.#.###.#.#####.#.###.#.###.#.###.#.###.#.###.#.#.#.#########.#.#.#.#.#####.###.#.#######.###.#####.#####.###.###.#########.###.#
#.#...#.......#.#.#...#...#.#...#.#.#...#.#.#...#.....#...#...#.#...#.#.......#...#.....#.....#.....#...#.....#.#...#.....#.#...#
#.#.#.#####.###.#.#.#####.#.###.#.#.#.###.#.#####.#####.#.#.#.#.#####.#.#####.#.###.###.###.###.#.###.#.###.###.###.#.###.###.#.#
#...#.#...#.#...#.#.#.....#...#.#.#.#...#.#.#.....#.....#.#.#.#.....#...#...#.#.#...#...#...#...#.#...#...#...#.#...#.#...#...#.#
#.#####.#.###.###.#.#.#######.#.#.#.###.#.#.#.#####.#####.#.#######.#####.#.#.#.#.###.#######.#####.#####.###.#.#.###.###.#.###.#
#.#.....#.....#...#.#.#...#.#...#...#...#...#...#...#.....#...#.....#.....#...#.#.#.#...#...#.......#.....#...#.#...#...#...#.#.#
#.#.#.#########.###.#.#.#.#.#######.#.#########.#.#####.#####.#.#######.#####.#.#.#.###.#.#.###.#####.#####.###.###.###.#####.#.#
#.#.#.#.....#...#.#.#...#.....#...#.#...........#.....#.#.....#.......#.#...#.#.#.#...#...#...#.#.....#...#...#.#...#.#.#.......#
#.#.#.#.###.#.###.#.#########.#.#.#####.#############.#.###.#########.###.#.###.#.#.#.#######.###.#####.#.###.#.#.###.#.#.#######
#.#.#.#...#...#...#...#.....#...#.....#.#...#.....#...#...#.......#.#...#.#.....#.#.#.......#...#.......#.#.#...#.....#.#...#...#
#.#.#.###.#####.#.#.#.#.#.###########.#.###.#.#.###.#####.###.###.#.###.#.#######.###.#.#######.###.#####.#.#.#####.###.###.#.###
#.#.#.#.........#.#.#...#.#...#.......#...#...#...#.#...#...#...#.....#...#...#...#...#.#.....#...#.....#.#...#...#.#...#...#...#
###.#.#.#######.###.#######.#.#.#########.#######.#.#.#.###.###.#.#########.#.#.###.###.#.#.#####.#.#####.#####.#.#.#.###.#####.#
#...#.#.#.....#.#...#.......#.#.......#.#.....#...#.#.#.#.......#.#...#...#.#...#...#...#.#...#...#.#.....#.....#...#...#.....#.#
#.#####.#.###.#.#.###.#######.#######.#.#####.#.#.#.#.#.#####.#####.#.#.#.#.#####.#####.#.###.#.###.#.#####.#######.###.#####.#.#
#.#...#.#...#.#.#...#.......#.....#...#.....#...#.#...#.#...#.#.....#.#.#.#.....#.#...#.#...#...#...#...#...#.....#...#...#...#.#
#.#.#.#.###.#.#####.#.###########.#.###.###.#####.#####.#.#.###.#####.#.#.#.###.#.#.#.#####.#####.#####.#.###.###.###.###.#.###.#
#.#.#.....#.#.....#...#...........#.#.#.#.#.......#...#...#.#...#...#...#.#.#...#...#.....#.#...#.....#.#...#.#...#...#...#.....#
#.#.#######.#####.#####.###########.#.#.#.#########.#.#####.#.#####.#####.###.###########.#.###.#.#####.###.#.###.#####.###.#####
#...#.......#.....#.....#.........#.#.#.#.........#.#.......#...#.......#...#.......#...#.#...#...#...#...#.#...#.....#...#.#...#
#.###.#######.#####.#####.#######.#.#.#.#######.###.#######.###.#.#########.#.#####.#.#.#.###.###.#.#.###.#.###.#####.###.#.#.#.#
#...#.#.....#.....#.......#...#...#.#.....#...#...#.....#.....#.#...#.......#...#...#.#...#.#...#.#.#.....#.#.#.#.........#.#.#.#
###.#.#.###.#####.#########.#.#.#.#.#####.#.#.###.#####.#######.#.#.#.###########.###.###.#.###.###.#.#####.#.#.#############.###
#...#.#...#.....#.........#.#...#.#...#.....#...#.....#.#...#...#.#.#...........#.#...#...#...#.....#.#.....#.#.#.........#...#.#
#####.###.###.###########.#.#####.###.#########.###.###.#.#.#.#####.###########.#.#.#####.###.#######.#.#####.#.#.#######.#.###.#
#...#.#.....#.#.....#.....#.#.......#.#.....#.......#...#.#...#.......#.......#...#.....#.......#.....#...#...#...#.....#...#...#
#.#.#.#######.#.###.#.#####.#########.#.###.#.#######.#.#.#####.#####.#.###.#######.###.#####.###.#######.#.#########.#.#####.###
#.#.#.......#.#...#.#.....#.#.........#...#.#...#.....#.#.#.......#.....#...#.....#.#.#.#...#.#.....#...#.#.....#.....#.#.......#
#.#.#######.#.#.###.#####.#.#.###########.#.###.#.#######.#######.###########.#.#.#.#.#.#.#.###.#####.#.#.###.#.#.#####.#####.#.#
#.#.......#.#...#...#.....#...............#.#...#.......#.......#.#.........#.#.#.#.#.#...#...#.#.#...#...#...#.#.#.#.......#.#.#
#.#######.#.#####.###.#####################.#.#########.#######.#.#.#######.#.#.###.#.#######.#.#.#.#######.###.#.#.#.#####.###.#
#...#...#.#.#...#...#.........#...#.....#...#...#.......#...#...#.#.#.....#.#.#.....#.......#...#.#.#.#.....#...#.#...#...#.....#
###.#.###.#.#.#.#.#.#########.#.#.#.###.#.#####.#.#####.###.#.###.#.#.###.#.#.#######.#####.#####.#.#.#.#.###.###.#.###.#.#######
#...#.#.....#.#.#.#.......#...#.#...#...#.#.....#.#.....#...#.#.#...#.#...#...#.......#...#.......#.#...#.#.......#...#.#.......#
#.###.#.#####.#.#.###.#.###.###.#####.###.#######.#.#####.###.#.#.#####.#.#########.###.#.###.#####.#.###.###########.#.#######.#
#...#.#.#...#.#.#.#.#.#.#...#.......#...#...#.....#.#.#.....#.#...#.....#.....#.....#.#.#.....#.....#.#...#.......#...#.....#...#
###.#.#.#.#.#.#.#.#.#.###.#########.###.###.#.#####.#.#.###.#.#.###.#.#######.#.#####.#.#######.#######.#.#.#####.#.#######.#.###
#...#.#.#.#...#.#...#...#.........#...#...#...#.#...#.#.#...#.#.....#.#.....#...#.....#.#...#...#.......#.#.#...#.#.#.......#...#
#.###.#.#.#####.###.###.#########.#####.#.#####.#.###.#.#.#.#.#########.###.#####.#.###.###.#.###.#.###.###.#.###.###.#########.#
#.#.....#.#.....#.....#.......#.#.....#.#.....#.#...#...#.#.#.........#...#.#.....#...#...#.#...#.#.#...#...#...#...#.#.......#.#
#.#######.#.#####.#####.#####.#.#####.#.###.#.#.###.###.#.###########.###.#.###.#####.###.#.###.#.#.###.#.#####.###.#.#.#####.#.#
#.........#.#.....#.....#...#.#.#.....#...#.#.#...#...#.#...........#.....#...#.....#...#.#...#.#.#...#.#.....#...#...#...#...#.#
#######.###.###.###.#####.#.#.#.#.#######.#.#.#.#.###.###.#######.#####.#####.###.###.###.#.#.#.#.###.#.#####.#.#######.###.###.#
#.....#...#...#...#...#...#.#.#.#.#.....#.#.#.#.#...#...#.....#...#...#.....#...#.#...#...#.#.#.#.#...#...#...#.........#...#...#
#.###.#######.#######.#####.#.#.#.#.###.#.#.#.###.#.###.#.#####.###.#.#########.#.#.###.###.#.#.###.#####.#.###.#########.#.#.#.#
#...#.#.....#.....#...#.....#...#.#...#.#.#.#.....#.#...#.#.....#...#.......#...#.#.........#.#.#...#.....#.#.#.#.....#...#.#.#.#
###.#.#.###.#####.#.###.#.#####.#.#####.#.#.#########.#####.###.#.#########.#.###########.#####.#.#########.#.#.###.###.#.###.#.#
#...#.#...#.......#.#...#.#.....#.....#...#.#.......#.......#...#.#.......#.#.#.........#.#.....#...#...#...#.......#...#.#...#.#
#.###.###.#########.#.#.###.#########.#.###.#.#####.#########.###.#.###.###.#.#.#######.###.#####.#.#.#.#.#######.###.###.#.#####
#.#.......#...#.....#.#.#.........#...#...#.#.....#.......#.....#.#.#...#...#.#.#.....#.#...#...#.#...#...#...#...#...#...#.....#
#.###########.#.###.#.###.#######.#.#######.#.#####.###.###.#####.#.#.#.#.###.#.#.###.#.#.###.#.#.#########.#.#####.###.#######.#
#.#.....#...#.#...#.#.......#...#.#...#...#...#...#...#.......#...#.#.#.#...#...#.#...#.#...#.#...#...#...#.#.....#.#...#.......#
#.#.###.#.#.#.###.#.#####.###.#.#####.#.#.#####.#.#############.###.#.#####.#####.#.###.###.###.###.#.#.#.#.#####.#.###.#.#####.#
#...#.#...#.#...#.#.....#.#...#.........#.......#.....#.........#...#.......#.....#...#...#...#.....#...#...#.#...#...#.#...#...#
#.###.#####.#.#.#.#####.###.#########################.#.#########.#########.#.#######.#.#.###.###############.#.###.#.#####.#####
#.....#...#.#.#.......#...........#.........#...#.....#.....#.#...#...#...#.#.#.#...#.#.#...#.........#.........#...#.....#.....#
#####.###.#.#########.#########.###.#######.#.#.#.#########.#.#.#####.#.#.#.#.#.#.#.#.#.###.#########.#.#####.###.#######.#####.#
#...#...#.#.....#...#.#.....#...#...#.#...#...#.#.#.........#.#...#...#.#.#...#...#.#.#.#.....#.....#.#.#...#...#.#...#.......#.#
#.#.###.#.#####.#.#.#.#.###.#####.###.#.#.#####.#.#####.#####.###.#.###.#.#######.#.#.###.###.#.#####.###.#.###.###.#.#.#####.#.#
#.#...#.#.....#.#.#...#.#.#...#...#...#.#.......#.#.....#.......#...#...#.#.....#.#.#...#...#...#.....#...#.#.#.....#...#...#.#.#
#.###.#.###.#.#.#######.#.###.#.###.#.#.#.#######.#.#####.###.###.###.###.#.###.#.#.###.#.#.#####.#####.###.#.#########.#.#.###.#
#.#.#.#.#...#.#.......#.#...#.#.#...#.#.#.#...#.....#.....#.#.....#...#.#.....#.#.#...#.#.#.#...#.......#.#.#...#.....#.#.#.....#
#.#.#.#.#.###.#######.#.#.###.#.#.###.#.###.#.#######.#####.#######.###.#######.#.#.###.#.#.#.#.#########.#.#.###.#.###.#.#######
#...#...#...#.....#.#...#.#...#.#.#...#.#...#...#.#...#.....#.....#.#...#.....#.#.#.....#.#...#.....#...#...#.....#.....#.......#
###.#####.#.#####.#.#####.#.###.###.#.#.#.#####.#.#.###.#####.###.#.#.#.#.###.#.#.#######.#####.###.#.###.###.#################.#
#.#.#.....#.#...#.#.....#.#.........#.#...#...#.#...#.........#...#.#.#.#.#.#...#.......#.....#.#.#.#...#.#.....#.....#.........#
#.#.#######.#.#.#.#.#.#.#.#################.#.#.#.###.#########.###.#.#.#.#.###########.#####.#.#.#.#.#.#.#######.###.#.#######.#
#.#.....#...#.#...#.#.#.....#...#.......#...#...#.#.....#.......#.....#.#.#...........#.....#.#.#.#.#.#.#.#.......#.#.#.#.....#.#
#.#####.#.###.#####.#.#######.#.#.#####.#.#######.#####.#.#####.#.#######.#.#####.#########.###.#.#.###.#.#.#######.#.#.#.###.#.#
#.....#...#.#...#...#.#.......#...#.....#.#.......#...#.#.....#.#.#.......#.#...#.........#.....#.#...#.#.#.....#.....#.#.#.#.#.#
#.###.#####.###.#.###.#.#########.#####.#.#.#######.#.#######.###.#.#.#####.#.#########.#.#######.###.#.#.###.#.#####.#.#.#.#.#.#
#.#.......#.....#...#.#.........#.#...#...#.#...#...#...#.....#...#.#.#...#.#.....#...#.#.#...#.....#...#...#.#.#...#...#.#.#...#
###.#.#####.#########.#########.###.#.#####.#.###.#.###.#.#####.###.#.#.#.#.###.#.#.#.#.###.#.#.###.###.###.###.#.#.#####.#.#####
#...#.#.....#.........#.....#.#.....#.#...#.#.....#...#...#.......#.#.#.#.#.....#...#.#.....#.....#.....#...#...#.#...#.#...#...#
#.#####.#######.#####.#.###.#.#######.#.#.#.#######.#.#####.#######.#.#.#.#####.###########.#####.#######.###.###.###.#.###.#.#.#
#...#...#.......#.#...#...#.....#...#.#.#.........#.#.#.....#.....#.#.#.#.....#.#.........#.#...#...#...#.#.....#.#...#...#...#.#
#.#.#.###.###.###.#.###.#.#####.#.#.#.#.#########.#.#.#.#####.###.#.#.#.#####.###.#######.###.#.#####.#.#.#.###.#.#.###.#######.#
#.#.#.#.#.#...#.....#...#.#...#.#.#...#.#.#...#.#.#.#.#...#.#...#...#.#.#...#.....#...#...#...#.......#...#...#...#...#.#.....#.#
#.#.#.#.#.#.###.#########.#.###.#.#####.#.#.#.#.#.#.#.###.#.###.#####.#.###.#########.#.#.#.#######################.#.#.#.###.#.#
#.#...#...#.#.#.#.........#.#...#.....#.#.#.#.#...#.#...#...#.#.....#.#.#.............#.#.#.#.....................#.#.#.#.#.#...#
#.#####.###.#.#.#.#########.#.#######.#.#.#.#.###.###.#####.#.#####.###.#.###########.#.###.#.#######.###########.###.#.#.#.#####
#...#...#...#.#...#...#.......#.....#.#...#.#...#.....#...#.#.....#.....#...#.#...#...#.#...#.#...#...#...#.....#.....#...#.....#
###.#####.###.#####.#.#.###########.#.#####.###.#######.#.#.#####.#########.#.#.#.#.###.#.#####.#.#.###.#.#.#.#########.###.###.#
#.........#.........#...............#.........#.........#...................#...#.....#.........#...#...#...#...............#...#
#################################################################.###############################################################
