#################################################################.###############################################################
#.....#.#.....#.......#.......#...#.......#.............#.....#...#.......#...#.............#...............#.............#.....#
#.#.#.#.#.###.#.#.###.#.#####.#.#.#.###.###.#########.#.###.#.#.#.#.#####.###.#.#######.###.#.#########.#.###.###.#######.#.###.#
#.#.#...#...#...#.#...#...#...#.#.#.#.#.....#.....#.#.#.#...#...#...#...#...#.........#...#.#.....#.....#.#.....#...#...#.#.#...#
#.#.#######.#####.#.#####.#.#.#.#.#.#.#######.###.#.#.#.#.###########.#.###.#.###########.#######.#.#######.#######.#.#.#.###.#.#
#.#.#.......#.....#.#.....#.#.#.#...#.#.....#...#.#.#.#...#.#.........#.....#.#.....#.....#.......#.#.......#.......#.#...#...#.#
#.#.#.#######.#######.#####.###.#####.#.###.#.#.#.#.#.#####.#.#########.#######.###.#.#####.#######.#.#######.#######.#####.###.#
#.#.#.#.#...#.......#.#...#...#...#.......#...#.#...#.....#...#...#...#.......#.#...#...#...#.....#.#.......#.#.....#.#.....#...#
###.#.#.#.#.#.#####.#.###.###.###.#####.#####.#.###.#####.#####.#.#.#.#.#####.#.#.###.#.#.###.###.#.###.#####.#.#####.#.#.###.###
#...#.#.#.#.#.#.....#.#.....#...#.....#.#...#.#...#...#.#.....#.#...#.#.#...#...#.#...#.#...#.#.....#...#.....#...#...#.#.#.....#
#.#.#.#.#.#.###.###.#.#.###.###.#####.###.#.#.###.###.#.#####.#.#####.###.#.#####.#####.###.#.#####.#.###.#####.#.#.###.#.#####.#
#.#.#.#.#.#.....#...#...#.#...#.....#.#...#.#.#.#.#.#.#...#.#...#...#.#...#.....#.....#.....#.....#.#.#.#.#.....#.#.#...#...#...#
#.###.#.#.#######.#######.###.#.#.###.#.###.#.#.#.#.#.#.#.#.#####.#.#.#.#######.#####.#.#########.###.#.#.#.#####.#.#.#####.#####
#.....#.#.....#.#.#.........#.#.#.#...#...#.#...#.#.#.#.#.#.#.....#...#.#.#...#.#...#.#.........#.......#.#.#...#.#.#...#.#.....#
#.#####.#####.#.#.#.#######.#.#.#.#.#####.#.#####.#.#.#.#.#.#.#######.#.#.#.#.#.#.#.#.#########.#######.#.#.###.#.#.###.#.#####.#
#.#.......#...#...#.#...#...#.#.#.#.......#.....#.#...#.#...#.......#.#.#...#.#...#.#.......#...#...#...#.#.....#.#...#.......#.#
#.###.###.#.#####.#.#.#.#.#.#.#.#.#############.#.#.###.###.#######.###.###.#.#####.#.#####.###.#.#.#####.#######.###.###.#####.#
#.....#...#.#...#.#.#.#...#.#.#.#...#...#.....#...#.#.....#.#.....#...#...#.#.....#.#.#...#...#.#.#.......#...#...#...#...#.....#
###.#######.#.#.#.###.#####.#.#.#####.#.#.#.#.#####.#####.#.###.#.###.###.#######.#.###.#.###.###.#########.#.#.###.#######.###.#
#...#.......#.#.#.....#.....#.#...#...#...#.#.#...#.......#.#...#.#.#...#.........#.....#.#...#...#.........#.#.#...#.......#...#
#.###.#######.#.#######.#####.###.#.#######.###.#.#########.#.###.#.#.###.#######.#######.###.#.###.#.#######.#.#.###.#.#####.###
#.#.#.........#...#.........#.#.#.#.#.....#.#...#...#.....#...#.#...#.....#...#.#.#.....#...#.#...#.#.#...#...#.#.#...#.....#...#
#.#.#############.#.#########.#.#.#.#.#.###.#.###.#.#.#.#######.###.#######.#.#.#.#####.###.#.###.#.#.#.###.###.#.###.#####.###.#
#.......#.......#.#.#...#.....#.#...#.#.#...#...#.#...#.#.........#.#.....#.#.#...#.....#.#.#...#.#.#.#.........#...#...#.#.#...#
#######.#.#####.#.###.#.#.#####.#######.#.#####.#.#####.#.#.#######.###.#.#.#.###.#.###.#.#.###.#.#.#.#.###########.###.#.#.#.###
#...#...#.#.....#.....#.#.#.........#...#.#...#.#.#...#.#.#.....#.......#.#.#...#...#.#...#...#...#.#.#.....#.......#...#.#.#...#
#.#.#.#####.###########.#.#.###.###.#.###.#.#.#.#.#.###.#.#####.#.#######.#.###.#####.###.###.#######.#######.#######.###.#.###.#
#.#...#...#.#.....#.....#.#...#.#.....#...#.#...#.#.#...#.....#.#.#.#...#.#.#...#.......#.#...#.....#.......#.....#.#.#...#.#.#.#
#####.#.#.#.#.#.###.#####.#####.#.#####.###.#####.#.#.#####.###.#.#.#.#.#.#.#.###.###.###.#.###.###.#######.#####.#.#.###.#.#.#.#
#...#...#.#...#.#...#.....#...#.#.#.....#...#.....#...#.....#...#.#.#.#.#.#.#...#...#...#.#.#...#.........#.#.....#.......#.#...#
#.#.#####.#####.#.###.#####.#.#.#.#.#####.###.#####.###.#####.#.#.#.#.#.###.###.###.###.#.#.#.#.#########.#.#.###########.#.#####
#.#.....#.......#.....#.....#...#.#.#.....#.#.#.......#.#...#.#.#...#.#...#.#.#...#...#.#.#.#.#.........#.#.#...#.......#.#.....#
#.#####.#######.#######.#.#########.#.#####.#.#########.###.#.#####.#.###.#.#.###.#####.#.#.###.#######.#.#.###.###.###.#######.#
#...#...#.......#.......#.#.........#.#.....#.#.......#...#.#.......#.#.#...#...#.....#...#...#.#...#.#.#.....#.....#.#.#.....#.#
###.#.#########.#####.###.#.#########.#.#####.#.#####.###.#.#########.#.#####.#######.#######.#.#.#.#.#.#############.#.#.###.#.#
#...#.........#.#...#.#...#.......#...#.#...#.#...#.#.....#.......#...#.....#.......#.........#...#...#.....#.........#.#.#.....#
#.###########.#.#.#.#.#.#########.#.###.#.#.#.###.#.###########.#.#.###.###.#.#.###.###########.#####.#####.#.###.#####.#.#####.#
#.#...#...#.#.#.#.#.#.#.....#...#...#...#.#...#.#.#.#...........#.#.#.....#...#...#.........#...#...#.#...#...#.#...#...#.....#.#
#.#.#.#.#.#.#.#.#.#.#######.#.#.#####.#.#.###.#.#.#.#.###.#######.#.#####.#######.###########.###.#.###.#.###.#.###.#.#######.#.#
#...#.#.#.#.#.#...#.#.....#...#.......#.#.#.....#.#...#...#.#.....#...#.#.......#...........#.#...#.....#...#.#...#.#.#.......#.#
#####.#.#.#.#.#####.#.###.#####.#######.#.#####.#.#####.###.#.#######.#.#######.###########.#.#.###########.#.###.#.#.#.#######.#
#...#...#.#.#.#.....#...#.....#.....#...#.....#.#.......#.#...#.#.....#.....#...#.........#...#...#.......#.#...#.#.#.#.....#...#
#.#.###.#.#.#.#.#####.#.#####.#####.#########.###########.#.###.#.#####.###.#.#####.#.###.#######.###.###.#.###.#.#.#.#####.#.###
#.#...#.#.#...#...#...#.#...#.....#.#...#.....#.......#.....#...#...#.#...#.#.....#.#...#.#.#.....#...#...#.#...#.#.#...#...#...#
#.###.###.#.#####.#.###.#.#.#####.#.#.#.#.###.#.#.#####.#####.#.###.#.#.#.#######.#####.#.#.#.#####.#.#####.#.###.#.###.#.#####.#
#...#.....#...#...#.#...#.#...#...#...#.#.#...#.#.....#.#...#.#...#.#...#.#.............#...#.#.#...#.#.....#.....#.#...#...#.#.#
#.#.#########.#.#####.###.###.#.#####.#.#.#####.#####.#.#.#.#.###.#.#####.#.###############.#.#.#.#.###.###########.#.#####.#.#.#
#.#.....#.#...#.......#.....#.#.....#.#.#.......#.#...#...#.#...#.#.....#...#.......#.......#.#.#.#...#.#.....#...#.........#.#.#
#.#####.#.#.#################.#####.###.#########.#.#######.#####.#####.#####.#####.#########.#.#.###.#.#.###.#.#.###########.#.#
#.....#.#...#...........#.......#.#...#...#.....#.#.#.....#.....#.....#.....#.#.#...#.......#.#.#...#.#...#.#...#.......#.......#
#######.#.###.#########.#.#####.#.###.#.#.#.#.#.#.#.#.###.#####.#.#.#######.#.#.#.#.#.#####.#.#.###.#.#####.#####.#####.#######.#
#...#...#.....#...#...#.#.#.....#...#...#.#.#.#...#...#...#...#.#.#.....#...#...#.#.#...#...#.#.#...#.......#...#.....#.#.....#.#
#.#.#.#########.#.#.#.#.#.#.#####.#######.###.###.#####.#.###.#.#.#####.#.#####.#.#####.#.#.#.#.#.#######.###.#.#####.#.#.###.#.#
#.#...#.......#.#.#.#...#.#...#...#.....#.....#...#...#.#...#.#.#.#.....#.......#.....#.#.#.#.#.#.....#...#...#.#...#.#...#.#.#.#
#.###.#####.###.#.#.#####.###.###.#.###.#######.#####.#.###.#.#.#.#.###.###########.#.#.#.#.#.#.#####.#.###.###.#.#.#####.#.#.###
#...#.#...#.....#...#.#.....#.#...#...#...#.....#.....#...#...#.#.#...#.#...#.....#.#.#.#.#.#.#.......#.#...#.#.#.#.....#...#...#
#.#.###.#.###.#######.#.###.#.#.#####.#.###.#####.#######.###.#.#.###.#.#.#.#.###.#.###.#.###.#.#####.#.#.###.#.#.#####.#.#####.#
#.#...#.#...#...#...#...#...#...#...#.#.....#...#.#.....#...#.#.#...#.#...#.#...#...#...#.#...#.#...#.#.#.#...#.#...#.#.#.#...#.#
#.###.#.###.###.#.###.###.###.###.#.#.#######.#.#.#.###.###.###.#####.###.#####.#####.###.#.###.#.#.###.#.###.#.###.#.#.###.#.#.#
#...#.....#.#.#.#...#...#.#...#...#...#.......#...#...#.....#...#...#.#...#.....#.......#.#.#...#.#...#.#...#.#.....#...#...#...#
###.#######.#.#.#.#.###.#.#####.#########.#.#####.###.#######.###.#.#.#.###.###.#.#######.#.###.#.###.#.###.#.#######.###.#######
#.#.#...#...#...#.#.#...#.....#.#.......#.#.#.......#...#.....#...#...#.#.#.#...#.#.......#...#.#.#.#...#...#.....#...#.....#...#
#.#.###.#.#####.#.#.#.#######.#.###.###.###.#.#########.#.#####.#.#####.#.#.#.###.#.#####.###.###.#.###.#.###.###.#.###.###.#.#.#
#.......#.....#.#.#.........#.#...#.#.#.....#.#...#.....#.#.....#.#...#...#.#.#...#.#.#.....#.....#.....#.#...#...#.#...#.#...#.#
#####.#######.#.#.#########.#.###.#.#.#######.#.#.#.#.###.#.#####.#.#.#####.###.###.#.#.#########.#####.#.###.#.###.#.###.#####.#
#...#.#.......#.#...#.....#.#...#...#.....#.#.#.#.#.#.#...#...#...#.#.......#.....#.#...#.#.......#...#.#.#...#.#...#.....#...#.#
###.###.#######.###.#.###.#####.#####.###.#.#.#.#.#.#.#.#####.#.###.#######.#.#####.#.###.#.#######.#.###.#.#####.#######.#.###.#
#.#.....#.....#.#.#.#.#.........#.....#.....#.#.#.#.#.#...#...#.#...#.....#.#.#.#...#...#.#...#...#.#.....#.#.....#...#...#...#.#
#.#######.#####.#.#.#.###########.#.#########.#.###.#.###.#.###.#.###.#####.#.#.#.#####.#.###.#.###.#######.#.#######.#.#####.#.#
#...#.....#...#.#...#.........#...#.#...#.......#...#.#.#.#...#.#.#.#.......#.#.#...#.......#.#.#...#...#...#...#.....#.#.....#.#
###.#.###.#.#.#.#.###########.#.###.#.#.#.#######.###.#.#.#####.#.#.#.#######.#.###.#######.#.#.#.###.#.#.#.###.###.###.#.#.#.#.#
#...#.#.#...#.#.#.........#.#...#...#.#.....#.....#.#...#...#...#.#...#...#...#...#.......#.#.#.#.#...#...#...#...#.....#.#.#.#.#
#.#.#.#.#####.#.#########.#.#####.###.#######.#####.###.###.#.#.#.###.#.###.###.#####.###.###.#.#.#.#######.#####.#.#######.###.#
#.#.#.#...#...#.#.....#.#.......#...#.#.#...#.#...#...#...#.#.#.#...#...#.......#...#...#...#...#.#.......#.#...#.#.....#...#...#
#.#.#.#.#.#.###.###.#.#.#######.###.#.#.#.#.#.#.#.#.#.###.#.#.#.###.#####.#######.#.###.###.###.#.###.###.#.#.#.#.#####.#.###.#.#
#.#.#.#.#.#...#...#.#...#...#...#.#...#.#.#...#.#.#.#.....#...#...#.#.....#.#.....#.#.....#.#...#...#...#.#.#.#.#...#...#.#...#.#
#.###.#.#.###.###.#.###.#.#.#.###.#####.#.#####.#.###############.#.#.#####.#.#####.#.#####.#.#####.###.#.###.#.###.#.###.#.###.#
#.#.....#...#.#...#.#.....#.#.#.........#.......#.....#...........#...#.....#.#...#.#...#...#.#.....#...#...#.#...#.#...#.#...#.#
#.#.#########.#.###.#.#####.#.#.###.#################.#.###########.#######.#.#.#.#.###.#.###.#.#####.#####.#.#.###.###.#.###.###
#...#.....#...#...#.#.#...#.#.#...#.#.........#.....#.......#.....#.........#.#.#.#...#.#.....#...#...#...#...#...#...#.....#...#
#.###.###.#.#####.#.###.#.###.###.###.#######.#.###.#.#######.###.###########.#.#####.###########.#.###.#.#.#####.###.#####.###.#
#...#.#...#.#.....#.....#...#...#.....#.......#.#.#.#...#.....#.#.......#.....#.....#...........#.#.#...#.#.....#...#.#...#.#...#
#####.###.#.#.#############.###.#.#####.###.###.#.#.#.###.#####.#######.#.#######.#############.#.###.###.#######.#.#.#.###.#.###
#...#...#...#.....#...#...#.#...#.#...#.#...#...#...#.#...#.....#...#.....#.....#.#.......#.....#...#.#.#.......#.#...#.....#...#
#.#.###.###.#####.#.#.#.#.#.#.###.#.#.#.#####.#####.#.#.#####.#.#.#.#.#####.###.#.#.###.#.#.#######.#.#.#######.#.#########.###.#
#.#.....#.#.#...#...#...#.#.#...#...#.#...#...#...#.#.#.....#.#...#...#...#...#.#.#.#.#.#.#.#.......#.........#.#.........#.#...#
#.#######.#.#.#.#########.#.###.#####.###.#.###.#.#.###.###.###.#######.#.#.###.#.#.#.#.###.#.###.###.#########.#########.###.#.#
#...#.....#.#.#.#.#.....#.#.........#...#.#.....#.#...#...#...#.......#.#...#...#.#...#.....#...#.....#...#.....#.......#.....#.#
#.#.#.###.#.#.#.#.#.#.#.#.###.#####.###.#.#######.###.#######.#########.#####.###.###.#################.#.#.#########.#.#######.#
#.#.#.#...#...#.#.#.#.#.#...#.#...#...#.#...#...#...#.........#.........#.#...#.....#.#...........#...#.#...#.........#.#.....#.#
#.#.###.#######.#.#.#.#.###.###.#.###.#.###.#.#.###.#########.#.#########.#.###.###.#.#.#########.#.#.#.#######.#.#####.#.#####.#
#.#...#.....#...#...#.#.#...#...#.#...#.#...#.#...#.......#...#.......#...#.#.#.#.#.#.#.#...#.#...#.#...#.....#.#.#...#.#.....#.#
#.###.#.#.###.#######.#.#.###.###.#.#####.###.#.#########.###########.#.###.#.#.#.#.#.#.#.#.#.#.###.#####.#.#.#.#.###.#.#####.#.#
#.#...#.#...#.#.......#.#.....#.#.#.#.....#...#.........#...#.....#...#.#...#...#.#...#...#.#...#...#.#...#.#.#.#.#...#...#...#.#
#.#.###.###.#.#.#######.#######.#.#.###.###.#####.#####.###.#.###.#.###.#.###.###.#########.#.#####.#.#.###.#.###.#.#####.#.###.#
#.#.#...#.#...#...#...#.#.......#.#.#...#...#...#.....#...#...#.#...#...#...#.....#...#.....#...#...#...#...#.....#.#...#...#...#
#.#.#.###.#######.#.###.#.###.###.#.#.###.###.#.#.###.#########.#######.###.#####.#.#.#.#.#####.#.###.###.#########.#.#.###.#.###
#.#.#.#...#.......#.#...#.#.#.....#.#.#.....#.#.#...#.#.....#...........#.#.#...#...#...#.#...#...#.....#.........#.#.#...#.#.#.#
###.#.###.#.###.###.#.###.#.#######.#.#.#####.#.###.#.#.#.#.###.###.###.#.#.#.#.###########.#.###################.#.#.###.#.#.#.#
#...#...#.....#.#...#.#...#...#.....#.....#...#...#.#...#.#...#.#...#...#.#...#...#.........#.....#.......#.......#.....#...#.#.#
#.#####.#####.#.#.###.#.###.###.#########.#.#####.#.#####.###.###.###.###.#######.#.#############.#.#####.#.#####.#####.#####.#.#
#.....#.#...#.#.#.....#...#.....#.......#.#...#.#.#.....#.#.#.#...#...#.....#...#.#...#.....#...#.#...#...#.....#.#...#.....#...#
#.###.#.#.#.###.#########.#.#####.#####.#.###.#.#.#######.#.#.#.###.#####.#.#.#.#.###.###.#.#.#.#.###.#.#######.###.#.#########.#
#...#.#...#...#.........#.#.#.....#.....#...#.#...#.......#.....#...#.....#...#.#...#...#.#...#.#.....#.......#.....#...#.......#
###.#.#######.#######.#.#.#.###.###.#########.#.###.#############.#####.#######.#.#.###.#.#####.#############.#.#######.#.#######
#...#.......#.........#.#.#...#.#...#.......#.#...#.#.........#...#.....#.......#.#.#...#.#.....#.........#...#...#.#...#...#...#
#####.#####.###########.#.###.#.#.#######.#.#.###.#.#.#######.###.#.#####.#######.#.#.#####.#####.#######.#.#####.#.#.#####.###.#
#...#...#...#...#...#...#...#...#.....#...#...#.#.#.#...#...#...#...#.....#...#...#.#.#.....#.....#.......#.#...#...#.#...#...#.#
#.#.###.#.###.###.#.#.#####.#########.#.#######.#.#.###.###.###.#######.#####.#.###.#.#.###.#.#.#######.###.#.#.###.#.#.#.###.#.#
#.#...#.#.#...#...#.....#...#.......#...#.......#.#...#...#.....#.....#.#.....#...#.#...#...#.#.#.....#.....#.#.....#...#...#.#.#
#.###.###.#.###.#########.#####.###.#####.#.#####.###.###.###.###.###.#.#.#.#####.#####.#####.###.###.#######.#############.#.#.#
#.#.......#.#...#...#.....#.....#.#.#...#.#.......#.....#...#.....#.#.#...#.#...#.......#...#.#...#.#.#.....#.......#.....#...#.#
#.#########.#.###.#.#.#####.#####.#.#.###.#########.###.###.#######.#.#######.#.#####.###.#.#.#.###.#.#.###.#######.###.#.#####.#
#.....#.....#.#...#.#.....#...#.......#...#.......#...#.#.#...#.....#.#.......#.....#.#...#.#.#.#...#.#...#...#.....#...#.#...#.#
#####.###.###.#####.#####.###.#########.###.#####.###.#.#.###.#.###.#.#.###########.###.###.#.#.#.#.#.###.###.#.#####.###.#.#.#.#
#...#.#...#...#...#.#...#...#...#.......#.....#.......#.#...#.#...#.#.#.#.........#.....#.#.#...#.#.#...#.#...#.....#.#.#.#.#...#
#.#.#.#.#.#.###.#.#.#.#.###.#.#.#.###########.#########.#.###.###.###.#.#.#.#############.#.#.###.#####.###.#######.#.#.#.#.#####
#.#...#.#.#.....#...#.#.....#.#...#...........#.....#.....#...#...#...#.#.#.............#...#.....#...#...#.......#.#.#...#.....#
#.#####.#######.#####.#########.###.#########.#.###.#.#####.###.###.###.#.###########.###.#######.#.#.###.#.#####.#.#.###.###.#.#
#.....#.#.......#.....#...#...#.#.......#.....#...#.#...#...#...#...#...#.......#...#.....#...#...#.#...#.#...#.#...#...#...#.#.#
#.###.#.#.#######.#####.#.#.#.#.#######.#.#######.#.#####.###.###.###.#########.###.#######.#.#.###.###.#.###.#.#######.###.###.#
#.#.#.#.#.#.......#.....#...#.#.......#.#.#.......#.#.....#.....#.....#.......#...#.........#.#...#.#...#.#...#.........#.#.#...#
#.#.#.#.#.#.#########.#######.#######.#.###.#######.#.#########.#######.###.#.###.#####.###.#.###.#.#.###.#.###.#########.#.#.#.#
#...#.#...#.#...#.....#.....#.#...#.....#...#.#...#...#.........#.....#.#.#.#...#.....#...#.#.#...#.#.....#.#...#.........#.#.#.#
#.###.#####.#.#.###.###.#####.#.#.#.#####.###.#.#.#######.###.###.#.#.#.#.#.#########.#.###.#.#####.#######.#.#.###.#####.#.#.###
#.#...#...#.#.#.#...#...#...#...#.#.#...#.#.....#.#.......#...#...#.#.#...#.#...#...#.#.#...#.....#.#.....#.#.#...#.#.#...#.#...#
#.#.###.#.#.#.#.#.###.#.#.#.#####.###.#.#.#.#####.#.#.#########.###.#####.#.#.#.#.#.#.###.#######.#.#.#####.#####.#.#.#.###.###.#
#.#.....#.....#...#...#...#...........#...#.....#...#.............#.......#...#...#.......#.........#.............#...#.........#
#################################################################.###############################################################
